1 0 0 0 2 2 2 2 2 2 1 0 0 0 2 2 2 2 2 2 1 0 0 0 2 2 2 2 2 2 1 0 0 0 2 2 2 2 2 2 1 0 0 0 2 2 2 2 2 2
1 0 0 0 0 0 0 0 0 0 1 0 0 0 2 2 2 2 2 2 1 0 0 0 2 2 2 2 2 2 1 0 0 0 2 2 2 2 2 2 1 0 0 0 2 2 2 2 2 2
1 0 0 0 0 0 0 0 0 0 1 0 0 0 2 2 2 2 2 2 1 0 0 0 2 2 2 2 2 2 1 0 0 0 2 2 2 2 2 2 1 0 0 0 2 2 2 2 2 2
1 0 0 0 4 4 5 5 0 0 1 0 0 0 2 2 2 2 2 2 1 0 0 0 2 2 2 2 2 2 1 0 0 0 2 2 2 2 2 2 1 0 0 0 2 2 2 2 2 2
1 0 0 0 4 4 5 5 0 0 1 0 0 0 2 2 2 2 2 2 1 0 0 0 2 2 2 2 2 2 1 0 0 0 2 2 2 2 2 2 1 0 0 0 2 2 2 2 2 2
1 0 0 0 0 0 0 0 0 0 1 0 0 0 2 2 2 2 2 2 1 0 0 0 2 2 2 2 2 2 1 0 0 0 2 2 2 2 2 2 1 0 0 0 2 2 2 2 2 2
1 0 0 0 0 0 0 0 0 0 1 0 0 0 2 2 2 2 2 2 1 0 0 0 2 2 2 2 2 2 1 0 0 0 2 2 2 2 2 2 1 0 0 0 2 2 2 2 2 2
1 0 0 0 0 0 0 0 0 0 1 0 0 0 2 2 2 2 2 2 1 0 0 0 2 2 2 2 2 2 1 0 0 0 2 2 2 2 2 2 1 0 0 0 2 2 2 2 2 2
1 0 0 0 3 2 2 2 2 2 1 0 0 0 2 2 2 2 2 2 1 0 0 0 2 2 2 2 2 2 1 0 0 0 2 2 2 2 2 2 1 0 0 0 2 2 2 2 2 2
1 0 0 0 3 2 2 2 2 2 1 0 0 0 2 2 2 2 2 2 1 0 0 0 2 2 2 2 2 2 1 0 0 0 2 2 2 2 2 2 1 0 0 0 2 2 2 2 2 2
1 0 0 0 2 2 2 2 2 2 1 0 0 0 2 2 2 2 2 2 1 0 0 0 2 2 2 2 2 2 1 0 0 0 2 2 2 2 2 2 1 0 0 0 2 2 2 2 2 2
1 0 0 0 0 0 0 0 0 0 1 0 0 0 2 2 2 2 2 2 1 0 0 0 2 2 2 2 2 2 1 0 0 0 2 2 2 2 2 2 1 0 0 0 2 2 2 2 2 2
1 0 0 0 0 0 0 0 0 0 1 0 0 0 2 2 2 2 2 2 1 0 0 0 2 2 2 2 2 2 1 0 0 0 2 2 2 2 2 2 1 0 0 0 2 2 2 2 2 2
1 0 0 0 4 4 5 5 0 0 1 0 0 0 2 2 2 2 2 2 1 0 0 0 2 2 2 2 2 2 1 0 0 0 2 2 2 2 2 2 1 0 0 0 2 2 2 2 2 2
1 0 0 0 4 4 5 5 0 0 1 0 0 0 2 2 2 2 2 2 1 0 0 0 2 2 2 2 2 2 1 0 0 0 2 2 2 2 2 2 1 0 0 0 2 2 2 2 2 2
1 0 0 0 0 0 0 0 0 0 1 0 0 0 2 2 2 2 2 2 1 0 0 0 2 2 2 2 2 2 1 0 0 0 2 2 2 2 2 2 1 0 0 0 2 2 2 2 2 2
1 0 0 0 0 0 0 0 0 0 1 0 0 0 2 2 2 2 2 2 1 0 0 0 2 2 2 2 2 2 1 0 0 0 2 2 2 2 2 2 1 0 0 0 2 2 2 2 2 2
1 0 0 0 0 0 0 0 0 0 1 0 0 0 2 2 2 2 2 2 1 0 0 0 2 2 2 2 2 2 1 0 0 0 2 2 2 2 2 2 1 0 0 0 2 2 2 2 2 2
1 0 0 0 3 2 2 2 2 2 1 0 0 0 2 2 2 2 2 2 1 0 0 0 2 2 2 2 2 2 1 0 0 0 2 2 2 2 2 2 1 0 0 0 2 2 2 2 2 2
1 0 0 0 3 2 2 2 2 2 1 0 0 0 2 2 2 2 2 2 1 0 0 0 2 2 2 2 2 2 1 0 0 0 2 2 2 2 2 2 1 0 0 0 2 2 2 2 2 2
1 0 0 0 2 2 2 2 2 2 1 0 0 0 2 2 2 2 2 2 1 0 0 0 2 2 2 2 2 2 1 0 0 0 2 2 2 2 2 2 1 0 0 0 2 2 2 2 2 2
1 0 0 0 0 0 0 0 0 0 1 0 0 0 2 2 2 2 2 2 1 0 0 0 2 2 2 2 2 2 1 0 0 0 2 2 2 2 2 2 1 0 0 0 2 2 2 2 2 2
1 0 0 0 0 0 0 0 0 0 1 0 0 0 2 2 2 2 2 2 1 0 0 0 2 2 2 2 2 2 1 0 0 0 2 2 2 2 2 2 1 0 0 0 2 2 2 2 2 2
1 0 0 0 4 4 5 5 0 0 1 0 0 0 2 2 2 2 2 2 1 0 0 0 2 2 2 2 2 2 1 0 0 0 2 2 2 2 2 2 1 0 0 0 2 2 2 2 2 2
1 0 0 0 4 4 5 5 0 0 1 0 0 0 2 2 2 2 2 2 1 0 0 0 2 2 2 2 2 2 1 0 0 0 2 2 2 2 2 2 1 0 0 0 2 2 2 2 2 2
1 0 0 0 0 0 0 0 0 0 1 0 0 0 2 2 2 2 2 2 1 0 0 0 2 2 2 2 2 2 1 0 0 0 2 2 2 2 2 2 1 0 0 0 2 2 2 2 2 2
1 0 0 0 0 0 0 0 0 0 1 0 0 0 2 2 2 2 2 2 3 3 3 3 3 2 2 2 2 2 2 1 0 0 0 2 2 2 2 2 2 1 0 0 0 2 2 2 2 2
1 0 0 0 0 0 0 0 0 0 1 0 0 0 2 2 2 2 2 2 3 3 3 3 3 2 2 2 2 2 1 0 0 0 2 2 2 2 2 2 1 0 0 0 2 2 2 2 2 2
1 0 0 0 3 2 2 2 2 2 1 0 0 0 2 2 2 2 2 2 1 4 4 4 4 4 2 2 2 2 1 0 0 0 2 2 2 2 2 2 1 0 0 0 2 2 2 2 2 2
1 0 0 0 3 2 2 2 2 2 1 0 0 0 2 2 2 2 2 2 1 5 5 5 5 5 2 2 2 2 1 0 0 0 2 2 2 2 2 2 1 0 0 0 2 2 2 2 2 2
1 0 0 0 2 2 2 2 2 2 1 0 0 0 2 2 2 2 2 2 1 5 5 5 5 5 2 2 2 2 1 0 0 0 2 2 2 2 2 2 1 0 0 0 2 2 2 2 2 2
1 0 0 0 0 0 0 0 0 0 1 0 0 0 3 3 3 3 3 2 1 5 5 5 5 5 2 2 2 2 1 0 0 0 2 2 2 2 2 2 1 0 0 0 2 2 2 2 2 2
1 0 0 0 0 0 0 0 0 0 1 0 0 0 2 2 2 2 2 2 1 0 0 0 2 2 2 2 2 2 1 0 0 0 2 2 2 2 2 2 1 0 0 0 2 2 2 2 2 2
1 0 0 0 4 4 5 5 0 0 1 0 0 0 2 2 2 2 2 2 1 0 0 0 2 2 2 2 2 2 1 0 0 0 2 2 2 2 2 2 1 0 0 0 2 2 2 2 2 2
1 0 0 0 4 4 5 5 0 0 1 0 0 0 2 2 2 2 2 2 1 0 0 0 2 2 2 2 2 2 1 0 0 0 2 2 2 2 2 2 1 0 0 0 2 2 2 2 2 2
1 0 0 0 0 0 0 0 0 0 1 0 0 0 2 2 2 2 2 2 1 0 0 0 2 2 2 2 2 2 1 0 0 0 2 2 2 2 2 2 1 0 0 0 2 2 2 2 2 2
1 0 0 0 0 0 0 0 0 0 1 0 0 0 2 2 2 2 2 2 1 0 0 0 2 2 2 2 2 2 1 0 0 0 2 2 2 2 2 2 1 0 0 0 2 2 2 2 2 2
1 0 0 0 0 0 0 0 0 0 1 0 0 0 2 2 2 2 2 2 1 0 0 0 2 2 2 2 2 2 1 0 0 0 2 2 2 2 2 2 1 0 0 0 2 2 2 2 2 2
1 0 0 0 3 2 2 2 2 2 1 0 0 0 2 2 2 2 2 2 1 0 0 0 2 2 2 2 2 2 1 0 0 0 2 2 2 2 2 2 1 0 0 0 2 2 2 2 2 2
1 0 0 0 3 2 2 2 2 2 1 0 0 0 2 2 2 2 2 2 1 0 0 0 2 2 2 2 2 2 1 0 0 0 2 2 2 2 2 2 1 0 0 0 2 2 2 2 2 2
1 0 0 0 2 2 2 2 2 2 1 0 0 0 2 2 2 2 2 2 1 0 0 0 2 2 2 2 2 2 1 0 0 0 2 2 2 2 2 2 1 0 0 0 2 2 2 2 2 2
1 0 0 0 0 0 0 0 0 0 1 0 0 0 2 2 2 2 2 2 1 0 0 0 2 2 2 2 2 2 1 0 0 0 2 2 2 2 2 2 1 0 0 0 2 2 2 2 2 2
1 0 0 0 0 0 0 0 0 0 1 0 0 0 2 2 2 2 2 2 1 0 0 0 2 2 2 2 2 2 1 0 0 0 2 2 2 2 2 2 1 0 0 0 2 2 2 2 2 2
1 0 0 0 4 4 5 5 0 0 1 0 0 0 2 2 2 2 2 2 1 0 0 0 2 2 2 2 2 2 1 0 0 0 2 2 2 2 2 2 1 0 0 0 2 2 2 2 2 2
1 0 0 0 4 4 5 5 0 0 1 0 0 0 2 2 2 2 2 2 1 0 0 0 2 2 2 2 2 2 1 0 0 0 2 2 2 2 2 2 1 0 0 0 2 2 2 2 2 2
1 0 0 0 0 0 0 0 0 0 1 0 0 0 2 2 2 2 2 2 1 0 0 0 2 2 2 2 2 2 1 0 0 0 2 2 2 2 2 2 1 0 0 0 2 2 2 2 2 2
1 0 0 0 0 0 0 0 0 0 1 0 0 0 2 2 2 2 2 2 1 0 0 0 2 2 2 2 2 2 1 0 0 0 2 2 2 2 2 2 1 0 0 0 2 2 2 2 2 2
1 0 0 0 0 0 0 0 0 0 1 0 0 0 2 2 2 2 2 2 1 0 0 0 2 2 2 2 2 2 1 0 0 0 2 2 2 2 2 2 1 0 0 0 2 2 2 2 2 2
1 0 0 0 3 2 2 2 2 2 1 0 0 0 2 2 2 2 2 2 1 0 0 0 2 2 2 2 2 2 1 0 0 0 2 2 2 2 2 2 1 0 0 0 2 2 2 2 2 2
1 0 0 0 3 2 2 2 2 2 1 0 0 0 2 2 2 2 2 2 1 0 0 0 2 2 2 2 2 2 1 0 0 0 2 2 2 2 2 2 1 0 0 0 2 2 2 2 2 2